.#....#........#....#.
.T....T........T....T.
......................
......................
..XXXX...XXXX...XXXX..
......................
......................
..XXXX...XXXX...XXXX..
......................
......................
..XXXX...XXXX...XXXX..
......................
......................
..XXXX...XXXX...XXXX..
......................
......................
..XXXX...XXXX...XXXX..
......................
......................
..XXXX...XXXX...XXXX..
......................
......................
..XXXX...XXXX...XXXX..
......................
......................